#key	value
name	VidyAntara Family Retreat
owned-by	Relief Foundation
byline	Where every dawn is tranquil

safeName	vidyantara
iconName	VidyAntara
footer-message	Where every dawn is tranquil and time stands still.

siteMenuName	VidyAntara
ChatraID	none

mediakit	?content=ffe&paler=fffafa&node=B9D3E4&heading=D1EBFC&footer=aaa&dont-round-logo=1
fonts	cursive=Eagle+Lake&menu=Quintessential&menu-size=1.3rem

sections	more, sakhi
_later	impressions

phone	+91-94446-06456
whatsapp	919444606456
email	bookings@vidyantara.org
address	Narasingapuram Village<br />Elavur, Gummidipoondi, TN, India
timings	Fri 3 pm to Sun 12 noon

local-url	http://localhost/friends/vidyantara/
live-url	https://vidyantara.org/
year	2025
